#############################################################################
                                                                            #
#########################################################################   #
    #            #    #                              #             #        #
           #          #    ##### #############       #             #        #
######  ##########    #      #       #               #      #    ###        #
         #       #    # ######    ######    ##### #######   #      #####    #
  #           F  #           #       #    ####     #        ###    #        #
##### ################ ##########    #       #     #        #      #        #
            #     #      #   #               #     #####    #      #   S    #
            #            #                   #              #               #
#############################################################################
